wwwwwwwwwww
w---w-e-w-w
w-------w-w
w---w-----w
w-s-w-----w
wwwww-----w
w-------e-w
w---------w
wwwwwwwwwww